3M	MMM	
American Express	AXP	
AT&T T	
Boeing	BA	
Caterpillar	CAT	
Chevron	CVX	
Cisco Systems	CSCO	
Coca-Cola	KO	
DuPont	DD	
ExxonMobil	XOM	
General Electric	GE	
Goldman Sachs	GS	
The Home Depot	HD	
Intel	INTC	
IBM		IBM	
Johnson & Johnson	JNJ	
JPMorgan Chase	PM	
McDonald's	MCD	
Merck	MRK	
Microsoft	MSFT	
Nike	NKE	
Pfizer	PFE	
Procter & Gamble	PG	
Travelers	TRV	
UnitedHealth Group	UNH	
United Technologies	UTX	
Verizon		VZ	
Visa		V	
Wal-Mart		WMT	
Walt Disney		DIS	